acomodate=accommodate
acsesory=accessory
adn=and
adress=address
allready=already
alot=a lot
antartic=antarctic
aparent=apparent
april=April
aquaintance=acquaintance
artic=arctic
asma=asthma
august=August
batallion=battalion
beleive=believe
cantalope=cantaloupe
cheif=chief
CHF=congestive heart failure
cieling=ceiling
cinamon=cinnamon
circut=circuit
comittee=committee
concieve=conceive
corespondent=correspondent
december=December
decieve=deceive
diarrea=diarrhea
disatisfied=dissatisfied
dissappear=disappear
dissappoint=disappoint
divise=devise
doucment=document
ect=etc
edsspell=EDSSpell
Edwardo=Eduardo
embarass=embarrass
equiped=equipped
eroneous=erroneous
exagerate=exaggerate
existance=existence
fasinate=fascinate
february=February
Febuary=February
forclosure=foreclosure
foriegn=foreign
fragil=fragile
freind=friend
freinds=friends
friday=Friday
garantee=guarantee
gpt=sgpt
got=sgot
grammer=grammar
greive=grieve
greivence=grievance
hankerchief=handkerchief
heighth=height
hipocrisy=hypocrisy
hygene=hygiene
imbed=embed
independance=independence
indespensable=indispensable
interum=interim
iresistible=irresistible
january=January
jewlery=jewelry
jugment=judgment
july=July
june=June
kaki=khaki
labratory=laboratory
libary=library
lisense=license
litrature=literature
manuver=maneuver
mathmatics=mathematics
matress=mattress
mhz=MHz
miniscule=minuscule
mispell=misspell
molases=molasses
monday=Monday
morgage=mortgage
necesary=necessary
neice=niece
neumonia=pneumonia
november=November
nusance=nuisance
ocasion=occasion
occurence=occurrence
october=October
ocur=occur
paralel=parallel
parliment=parliament
porselain=porcelain
potatoe=potato
probly=probably
protege=prot‚g‚e
psycology=psychology
rasberry=raspberry
recieve=receive
recomend=recommend
reconize=recognize
repentence=repentance
rythm=rhythm
sanwich=sandwich
saturday=Saturday
secratary=secretary
seperate=separate
september=September
sieze=seize
sucess=success
sunday=Sunday
teh=the
thsi=this
thursday=Thursday
tobaco=tobacco
tomatoe=tomato
tuesday=Tuesday
vacinate=vaccinate
vacum=vacuum
wednesday=Wednesday
Wendsday=Wednesday
wierd=weird
